1111111111111
1C010000P0001
10000111100E1
1111111111111
