1111111111111
1001C00000001
1000011110001
1P00011000E01
1111111111111
