1111111111111
10C0100000001
1000011110001
1P00011000E01
1111111111111
