1111111111111
1PC0100000001
10000111100E1
1111111111111
