1111111111111
1PC0100000001
1000011110001
1000011000E01
1111111111111
