1111111111111
100100C000001
1000011110001
1P0011E000001
1111111111111
